0
11111111111111111111
10000000000000000001
10000000000000000001
10000000000000000001
10000000000000000001
10000000000000000001
10000000010000000001
10000000000000000001
10000000000000000001
10000000000000000001
10000000000000000001
11111111111111111111
0.87
33333333333333333333
30000000000000000003
30000000000000000003
30000000000000000003
30000000000000000003
30000000101000000003
30000000010000000003
30000000101000000003
30000000000000000003
30000000000000000003
30000000000000000003
33333333333333333333
1.02
33333333333333333333
30000000000000000003
30000000000000000003
30000000000000000003
30000001010100000003
30000000101000000003
30000001010100000003
30000000101000000003
30000001010100000003
30000000000000000003
30000000000000000003
33333333333333333333
1.17
11111111111111111111
10000000000000000001
10000000000000000001
10000000000000000001
10000000000000000001
10000000111000000001
10000000111000000001
10000000111000000001
10000000000000000001
10000000000000000001
10000000000000000001
11111111111111111111
5.56
33333333333333333333
30000000000000000003
30000000000000000003
30000000000000000003
30000000010000000003
30000000101000000003
30000010000010000003
30000000101000000003
30000000000000000003
30000000010000000003
30000000000000000003
33333333333333333333
5.7
33333333333333333333
30000000000000000003
30000000000000000003
30000100010001000003
30000000000000000003
30000000101000000003
30000010000010000003
30000000101000000003
30000000000000000003
30000100010001000003
30000000000000000003
33333333333333333333
5.85
11111111111111111111
10000000000000000001
10000000000000000001
10000000000000000001
10000000000000000001
10000000101000000001
10000000010000000001
10000000101000000001
10000000000000000001
10000000000000000001
10000000000000000001
11111111111111111111
800
00000000000000000000
00000000000000000000
00000000000000000000
00000000000000000000
00000000000000000000
00000000000000000000
00000000000000000000
00000000000000000000
00000000000000000000
00000000000000000000
00000000000000000000
00000000000000000000
